0000000000100100000
2111100001111100000
0100111101010100000
0100100101110100000
0111100111111100000
0000111001000100000
0111100000000100000
1100000011100111100
0000000110110000100
0111111101011111110
0100000110110010000
0111000011100011111
0001100001011110000
0001000001110010000
0111000000000010000
0010000111110011110
0010000110010001000
0011110000011111000
0000030000000000000     
